X      X  X     X XX  X      X X    XX   X X     X
XXXXXX     XXXX  XXX X  XXXX XX  XXXXX X X  XXXXX 
    X  XX   E  E  X   XX   X X XX   X  X X   M    
 X    MX   X X     X  X     X  X  X    XX XX    XX
  XXXXX  X XX   X X    X X   XX  X  XXXX   X  X  X
       XXX X XX    XX          XX    E  XXX     X 
XX  X   X    X  XM X   G E  X  X   X X XX     X   
XX X  X X X   X  XX  XXXXXXX    XX X  XXX XXXX  X 
X   XXX X      E   XX        E   X X   X      XXX 
  E   XXGXXE    X     X XX  X     X  X      X     
XXXXXXXX  X XXX  XXXXX   X X  XXX  XX E X XsXXXXXX
      X  X   W     E    X   XX E     XX   XsX     
XX       E      X        G   X    X  X  X      X  
XX XXXXXXXXXXXXX   X XXX X X X X X    X  X X X XXX
XM  GX      E              X X    XX    E    X X  
XX  X  X     X XX  G  X  X  X  X  X  G  X  X  X   
    X X  XXXX   X  X X  XE X  X  X   XE  XX  X  XX
 XX XX     E XXX      XX XX    XX  W              
 X   X X  X  X    XX      X X     X  X  X    G   X
  XXsX  XX    X X  XGXXXX XX   X   X  XX  XXX X   
   XsX  GM        X     X X XX  W   E      M      
XX XX  EX X  X XX  X  X  X   X X     X      X W   
XX  X X X  XX   X X    XX  X X  XXXX  XXXXX XXXXXX
X  X  X X    XXX     G   XXX X      G     X       
  X X     X  X   X X  X      XXX XX E  XX  X  X  X
X X  XXXXX  X  X X  XX  XXXX XXXG X XXX X X  X  X 
XEX    G  XX XXX X  G      X XXs X     X G XX XX X
XX  X  X   X             X  XE X  X XX  X  s  X  X
 X X    XX X X XXXXXXXXXX  X  X    XXX X  XXXX  X 
Xs  XX   X X    E  W E        G     X      E     X
XX      X    X   XWW  X   X  X X XX     X        X
XX XXXX X X X  X X X X  X XX XX   X  X X G XMXXXX 
Xs    X X  E XXXMX    E X XX X   X      XX E     X
 X   XXX      X      XX  X   G    X  X  X XX  X   
E XX XX  XXXX X X XXXXX   X X XXXX  X  X   X   XX 
   X Xs   E X X      X            XX XX XXX     X 
 X   X  X    X  X   XXX  X  X  X  X     X sW  X   
X  X XX XXXX  X  XX XXX   XX  X  X  XXX  XXXXX   X
   X XX X     G   X XX   WG    XX E       E   XX  
 X   X X  E           X  WM   XX XX  X  X   X  X X
X  X XX  XXX X  X XXXX   X XXX X  X   X  XX XX XX 
   X      E       E           X  XE       X XX X X
   XX E   X XX XX     X   X   XX     X  X E    X X
XXX X XXX  X X  X XXX  XX X X  X  X   XX  XXXX X  
   X        X  X   Ms   X X   X              X X  
 X    XX   X   XX  X  X  X      X X  X  X   X     
  X X  X XEX X  X  EXX  X   X X XX  X  X  X XXXXX 
      X  X X   X         XX   X X XX    XXX X   X 
  X    X  X  X  X  X  X XX  X   X       X    XX   
X XXXXX  X  X  X  X  X   X X  X XXXX X X  XXX X  X
