X      X  X     XXXX XX      X X    XX   X X     XXXXX X X X
XXXXXX     XXXX  XXX    XXXX XX  XXXXX X X   XXXX  E X X    
    Xs XX   E  E  X   XX   X   XX   X  X X   M    XXX X X  X
 X   SMX   X X     X  X     X  X  X    XX XXWsW XXXMX    E X
  XXXXX  X XX   X X    X X   X   X  XXXX   X  X  X      XX  
       XXX X XX    XX         XXX    E  XXX     X  X XXXXX  
XX  X   X    X  XM X   G E  X  X   X X XX     X         X   
XX X  X X X   X  XX  XXXXXX XXX XXXX  X  X   XXX X  XXXXXXXX
X   XXX X      E   XX        X      XXX   XX XXX XX XXXXX   
  E   XXGXXE    X     X XX X      X     S  X XX      E   XX 
XXXXXXXX  X XXX  XXXXX   X  E X XsXXXXXX       X  XX   X  X 
      X  X   W     E    X  XX   XsXW     X XXXX     XX XX XX
XX       E      X        G X  X   W  X  X X  XGXXXX  X XX X 
XX XXXXXXXXXXXXX   X XXX X  X  X X X XXX    X     XXXX X X X
XM  GX      E                 E    X X   XX  X  X  E X X    
XX  X  X     X XX  GG X  X G  X  X  X     X X    XXXXX X X X
    X X  XXXX   X  XGX  XE XE  XX  X  XXXX     G   E X X    
 XX XX     E XXX      XX XX    XX  W         sW      X X  X 
 X   X X  X  X    XX      X X     X  X  X    Gs  X X X  XX  
  XXsX  XX    X X  XGXXXX XX   X   X  XX  XXX X   XX X  G   
   XsX  GM        X     X X XX  W   E      M              X 
XX XX  EX X  X XX  X  X  X   X X     X      X W    XXXXXXXXX
XX  X X X  XX   X X    XX  X X  XXXX  XXXXX XXXXXX XXXXX   X
X  X  X X    XXX     G   XXX X      G     X    GS   E   XX  
  X X     X  X   X X  X      XXX XX E  XX  X  XSGXX   X  X X
X X  XXXXX  X  X X  XX  XXXX XXXG X XXXXX X  X  X  XX XX XX 
XEX    G  XX XXX X  G      X XXsSX     X G XX XX X  X XX X X
XX  X  X   X             X  XE X  X XX  X  s  X  XX E    X X
XX X    XX X X XXXXXXXXXX  X  X    XXX X  XXXX  XX  XXXX X  
Xs  XX   X X    E  WSE        G     X      E     X     X XG 
XX      X    X   XWW  X   X  X X XX     X        XX   X  GG 
XX XXXX X X X  X X X X  X XX XX   X  X X G XMXXXX  X  XX   X
XsS   X X  E XXXMX    E X XX X   X      XX E     X  E   XX  
 XS  XXX      X      XX  X   G    X  X  X XX  X   X   X  X X
E XX XX  XXXX X X XXXXX   X X XXXX  X  X   X   XX  XX XX Xs 
   X Xs   E X X      X            XX XX XXX     X   X XX XXX
 X   XssX    X  X   XXX  X  X  X  X     X sW  X   X E    XXX
X  X XX XXXX  X  XX XXX   XX  X  X  XXX  XXXXX   X  XXXX X M
   X XX X     GS  X XX   WG    XX E       E   XX       X Xs 
 X   X X  E           X  WMS  XX XX  X  X   X  X XX   X     
X  X XX  XXX X  X XXXX   X XXX X  X   X  XX XX XX X    XX X 
s  X      E       E           X  XE       X XX X X  E   X X 
   XX E   X XX XX     X   X   XX     X  X E    X X X     X  
XXXXX XXX  XXX  X XXX  XX X X  X  X   XX  XXXX X  X  XXX  XX
   X        XSSX   Ms   X X   X     ss       X X   XX E     
 X    XX   X SSXX  XMMX  X      X X  XX X   X       X    X  
M X X  X XEX XS X  EXX  X   X X XXs X  X  X XXXXX X X X X   
M     X  X X   X         XX   X XSXX X  XXX X   X X X    XX 
  X    X  X  X  X XX  X XX  X   XSs          XX    X  X  X  
X XXXXX  X  X  X  X  X   X X  X XXXX X X  XXX X  XX  X  X   
X  X   W     E    X  XX   XsXW     X XXXX     XX XX XX      
XX       E      X        G X  X   W  X  X X  XGXXXX  X XX X 
XX XXXXXXXXXXXXX   X XXX X  X  X X X XXX    X     XXXX X X X
XM  GX      E                 E    X X   XX  X  X  E X X    
XX  X  X     X XX  GG X  X G  X  X  X     X X    XXXXX X X X
X X  XXXX   X  XGX  XE XE  XX  X  XXXX     G   E X X        
XX XX     E XXX      XX XX    XX  W         sW      X X  X  
X   X X  X  X    XX      X X     X  X  X    Gs  X X X  XX   
XXsX  XX    X X  XGXXXX XX   X   X  XX  XXX X   XX X  G     
XsX  GM        X     X X XX  W   E      M              X    
