       X  X     X XX  X      X X    XX   X X     X
XXXXXXX    XXXX  X X X  XXXX XX  XXX X X X  XXXXX 
       XX         X   XX   X X XX   X  X X        
 X     X   X X     X  X     X  X  X     X XX    XX
  XXXXX  X XX   X X    X X   XX  X  XXXX   X  X  X
       XXX X XX    XX          XX       XXX     X 
XX  X   X    X  X  X        X  X   X X XX     X   
 X X  X X X   X  XX  XXXXXXX    XX X  X X XXXX  X 
X   XXX X          XX            X X   X      XXX 
      XX XX     X     X XX  X     X  X      X     
XXXXXX X  X XXX  XXXXX   X X  XXX  XX   X X XXXXXX
      X  X              X   XX       XX   X X     
XX              X            X    X  X  X      X  
 X XXXXXXXXXXXXX   X XXX X X X X X    X  X X X XXX
X                          X X    XX         X X  
 X  X  X     X XX     X  X  X  X  X     X  X  X   
X  X  X  XXXX   X  X X  X  X  X  X   X   XX  X  XX
 XX XX       XXX      XX XX    XX                 
 X   X X  X  X    XX      X X     X  X  X        X
  XX X  XX    X X  X XXXX XX   X   X  XX  XXX X   
   X X            X     X X XX                    
XX XX   X X  X XX  X  X  X   X X     X      X     
 X  X X X  XX   X X    XX  X X  XXXX  XXXXX XXXXXX
X  X  X X    XXX         XXX X            X X     
  X X     X  X   X X  X      XXX XX    XX  X  X  X
X X  XXXXX  X  X X  XX  XXXX X X  X XXX X X  X  X 
X X       XX XXX X         X XX  X     X   XX XX X
XX  X  X   X             X  X  X  X XX  X     X  X
 X X    XX X X XXXXXXXXXX  X  X    X X X  XXXX  X 
X   XX   X X                        X            X
XX      X    X   X    X   X  X X XX     X        X
 X XXXX X X X  X X X X  X XX XX   X  X X   X XXXX 
X     X X    XXX X      X XX X   X      XX       X
 X   X X      X      XX  X        X  X  X XX  X   
  XX XX  XXXX X X XXX X   X X XXXX  X  X   X   XX 
   X X      X X      X            XX XX XXX     X 
 X   X  X    X  X   XXX  X  X  X  X     X     X   
X  X XX XXXX  X  XX X X   XX  X  X  XXX  XXXXX  XX
   X XX X         X XX         XX             XX  
 X   X X              X       XX XX  X  X   X  X X
X  X XX  XXX X  X XXXX   X XXX X  X   X  XX XX XX 
   X X                        X  X        X XX X X
   XX     X XX XX     X   X   XX     X  X      X X
XXX X XXX  X X  X XXX  XX X X  X  X   XX  XXXX X  
   X        X  X        X X   X              X X  
 X    XX   X   XX  X  X  X      X X  X  X   X     
  X X  X X X X  X   XX  X   X X XX  X  X  X XXXXX 
      X  X X   X         XX   X X XX    XXX X   X 
  X    X  X  X  X  X  X XX  X   X       X    XX   
X XXXXX  X  X  X  X  X   X X  X XXXX X X  XXX X  X
